__###___
__#&#___
__#_####
###$_$&#
#&_$@###
####$#__
___#&#__
___###__