############################
#@______#_________#________#
#_##_####_#######_#_########
#__#______#________#_______#
#_######__#_#####_#_########
#______#__________#_#______#
#__#####_____######_########
#__#___#_##________________#
#__#__##_#__#############__#
#__#_____#__#___#__________#
#______####_##__#######_#__#
#_######__#_____________#__#
#_#_______#__##########_####
#______#__#________#_____$&#
############################