__####___
###__####
#_____$_#
#_#__#$_#
#_&_&#@_#
#########