___#####____
####___#____
#&&#$$_#____
#_&&$__#####
#_@#_#_#___#
#__$_____$_#
#__#######&#
####_____###