___###_____
__##_#_####
_##__###__#
##_$______#
#___@$_#__#
###_$###__#
__#__#&&__#
_##_##&#_##
_#______##_
_#_____##__
_#######___
