__####__
__#&&#__
_##_&##_
_#__$&#_
##_$__##
#__#$$_#
#__@___#
########