___####_
_###_@#_
_#__$_#_
##_#_###
#__#_#&#
#_#__$&#
#_$___&#
########