_____#######_
_____#__#__#_
_____#__$$_#_
######_$#__#_
#&&&###_#__##
#&__#__$_#__#
#&____$_$_$_#
#&__#__$_#__#
#&&&###_#___#
######_$___##
_____#_@#__#_
_____#######_