11 11
$$$$###$$$$ 
$$##$#$####
$##$$###$$#
##$=$$$$$$#
#$$$O=$#$$#
###$=###$$#
$$#$$#xx$$#
$##$##x#$##
$#$$$$$$##$ 
$#$$$$$##$$  
$#######$$$