8 12
$$$#####$$$$    
####$$$#$$$$    
#xx#==$#$$$$    
#$xx=$$#####
#$O#$#$#$$$#
#$$=$$$$$=$#
#$$#######x#
####$$$$$###
