6 9
$$####$$$   
###$$####
#$$$$$=$#
#$#$$#=$#
#$x$x#O$#
#########
  